........###########........
.....###           ###.....
....#                 #....
..##                   ##..
.#                       #.
#                         #
#                         #
.#                       #.
..##                   ##..
....#                 #....
.....###           ###.....
........###########........
